*************************************************************
*                                                           *
*        z        z                                         *
*                                                           *
*           @                                               *
*                                                           *
*        z        z                                         *
*                                                           *
*                                                           *
*                                                           *
*                                                           *
*                                                           *
*                                                           *
*                                                           *
*************************************************************