*************************************************************
*                                                           *
*        z  b     z                                         *
*          b  b                                             *
*   *********************                                   *
*                                                           *
*  **********************                                   *
*                    z                                      *
*   z      g   g  g                                         *
*                                                           *
*                                                           *
*                                                           *
*                                                           *
*                                                           *
*************************************************************