*****************************************
*                                       *
*  *****  *  * ****   **** **   * ***   *
*    *    *  * *      *    * *  * *  *  *
*    *    **** ***  @ ***  *  * * *  *  *
*    *    *  * *      *    *   ** *  *  *
*    *    *  * ****   **** *    * ***   *
*****************************************
