*************************************************************
*                                                           *
*   *****  *  * ****   **** **   * ***                      *
*     *    *  * *      *    * *  * *  *                     *
*     *    **** ***    ***  *  * * *  *                     *
*     *    * @* *      *    *   ** *  *                     *
*     *    *  * ****   **** *    * ***                      *
*                                                           *
*                                                           *
*                                                           *
*                                                           *
*                                                           *
*                                                           *
*                                                           *
*************************************************************
