*************************************************************
*                                                           *
*  *****     *     **   ** *****                           *
*  *        * *    * * * * *                                *
*  *       *****   *  *  * ***                              *
*  *  *   *     *  *     * *                                *
*  ****  *       * *     * *****                            *
*                                                           *
*  **** *       * **** *****                                *
*  *  *  *     *  *    *   **                               *
*  *  *   *   *   ***  ****                                 *
*  *  *    * *    *    * *                                  *
*  ****     *     **** *  *                                 *
*                                                           *
*************************************************************
