FINAL=1
^^^SETTINGS^^^
**********************************
*                                *
*  *****     *     **   ** ***** *
*  *        * *    * * * * *     *
*  *       *****   *  *  * ***   *
*  *  *   *     *  *     * *     *
*  ****  *       * *     * ***** *
*                                *
*  **** *       * **** *****     *
*  *  *  *     *  *    *   **    *
*  *  *   *   *   ***  ****      *
*  *  *    * *    *    * *       *
*  ****     *     **** *  *      *
*                                *
**********************************
